NO ./wall2.xpm
SO ./wall.xpm
WE ./wall2.xpm
EA ./wall.xpm

F 100   ,    200,   256
C   2,3,4

        1111111111111111111111111
        1000000000110000000000001
        1011000001110000000000001
        100100000000000000E000001
111111111011000001110000000000001
100000000011000001110111111111111
11110111111111011100000010001
11110111111111011101010010001
11000000110101011100000010001
100000000000000001100000010001
10000000000000001101010010001
11000001110101011111011110001
11110111 1110101 101111010001
11111111 1111111 11111111111

