NO ./wall.xpm 
SO ./wall.xpm
WE ./wall2.xpm
EA ./wall.xpm

F 135,206,235
C 135,206,235

        1111111111111111111111111
        1000000000110000000000001
        1011000001110000000000001
        1001000000000000000000001
111111111011000001110000000000001
100000000011000001110111111111111
11110111111111011100000010001
11110111111111011101010010001
11000000110101011100000010001
100000N0000000001100000010001
1000000000000011 01101010010001
11000001110101 1111101111000111
11110111 11101 1 101111010001
11111111 1111111 11111111111
