NO ./wall2.xpm
SO ./wall.xpm
WE ./wall2.xpm
EA ./wall.xpm

F ,206,235
C 188,129,95

11111
1N001
1N001
10001
11111
